8 8
_#####__
_#-@-###
##-#$--#
#-*.-.-#
#--$$-##
###-#.#_
__#---#_
__#####_