8 9
_#######_
_#-@--.#_
_#---####
###$----#
#---#$#-#
#-$-#.--#
#.----###
#######__