8 8
__###___
__#.#___
__#-####
###$-$.#
#.-$@###
####$#__
___#.#__
___###__