7 9
_########
_#--##-.#
##.-@$--#
#---#$--#
#$--#--##
#.-##--#_
########_