9 9
#####____
#@--#____
#-$$#_###
#-$-#_#.#
###-###.#
_##----.#
_#---#--#
_#---####
_#####___