7 8
########
#----.-#
#-#-#$-#
#@$.--.#
#####-$#
____#--#
____####