8 8
_####___
_#@-###_
_#-$--##
###.#-##
#.#-#--#
#-$--#-#
#.---$-#
########