7 8
__#####_
__#---##
__#-.--#
###@$#-#
#---$--#
###.####
__###___