7 9
__####___
_##--#___
_#---##__
##-#$.###
##-$..$@#
_#------#
_########