8 8
#####___
#-#-#___
#-.-####
##$-@--#
#.-#$#-#
#$-#.--#
#----###
######__